3d	virtual
alma	
almendras	suspiros
alpinismo	horizonte
amazonas	arcoiris
amig	pequecity
andorra	felices
anime	ilustrado
antropologico	conjuntos
arruga	sopa
artes	imaginapoder
autos	
aventuras	paralelas
avisos	metal
barroco	bohemio
blues	salsa
botones	sopa
buenosaires	felices
caballos	
cambiemoselmundo	imaginapoder
canario	losqueamamos
caricatura	ilustrado
caricias	suspiros
castillos	consola
cejas	sopa
celestial	imaginario
centros	imaginapoder
chacarera	salsa
chacra	arcoiris
charquitos	sopa
chef	expertos
chinchulines	sopa
cienciaficcion	
clasica	salsa
cocina	
colonia	felices
comedias	paralelas
comercial	metal
comida	sopa
copiarme	imaginapoder
criticas	paralelas
cubiertos	sopa
cumbia	salsa
cursos	metal
cyberia	imaginapoder
cyberjuegos	consola
danza	bohemio
deseado	felices
dibujo	bohemio
digital	virtual
dioses	arcoiris
disenio	metal
doctores	expertos
dragon	consola
dragones	
duendes	poetas
educacion	metal
elvasoylagota	sopa
empresas	metal
ensayo	poetas
escultura	bohemio
esquies	horizonte
estrellas	imaginario
etnologica	bohemio
exacta	imaginapoder
expertos	consola
fans	paralelas
fantasma	poetas
fantasmas	imaginario
favoritos	consola
ficcion	poetas
financiera	metal
flamenco	salsa
fotografia	bohemio
funky	salsa
gallinasygallos	sopa
golocinas	pequecity
gorilas	consola
gratis	metal
hardware	virtual
hormiga	sopa
howdeeee	bohemio
humanidades	imaginapoder
humor	ilustrado
inanimado	ilustrado
independiente	paralelas
informacion	metal
intelectuales	imaginapoder
interactiva	virtual
internet	virtual
jardin	losqueamamos
juegos	virtual
labios	suspiros
lahabana	felices
leyendas	imaginario
lilas	
locales	goleadores
loro	losqueamamos
lucha	consola
luchas	olimpica
luciernagas	sopa
maestras	expertos
marketing	expertos
memata	imaginapoder
mendoza	felices
miami	felices
musical	paralelas
nada	imaginapoder
naturista	arcoiris
newage	arcoiris
novatos	consola
oriental	paralelas
partidos	conjuntos
patos	sopa
periodista	expertos
personajes	ilustrado
piramides	arcoiris
planetario	ilustrado
poemas	poetas
pop	salsa
privada	conjuntos
productos	metal
profesor	expertos
pulgas	sopa
punk	salsa
rabo	sopa
realidadvirtual	virtual
reciclado	arcoiris
reggae	salsa
relatos	poetas
renacimiento	bohemio
rimas	poetas
rocknroll	salsa
ruleros	sopa
saber	poetas
salsa	salsa
serpiente	sopa
servicios	metal
shareware	consola
ska	salsa
skate	olimpica
sobrino	losqueamamos
social	conjuntos
software	virtual
solar	arcoiris
soldados	ilustrado
solidaridad	conjuntos
suenios	imaginario
tablon	goleadores
tango	salsa
tarot	arcoiris
tebeo	ilustrado
techno	salsa
tecnologia	virtual
tenis	olimpica
terapias	arcoiris
traductor	expertos
tropical	
trucos	consola
utopia	conjuntos
vecino	losqueamamos
vegetariano	arcoiris
vela	olimpica
ventanas	virtual
video	virtual
webones	virtual
zapatos	sopa
zip	virtual
zoologico	expertos
