007	lavender,lavendar
1966	wembley
3com	skyscraper
3d	underworld
4skins	tinpan
808	tinpan
aaron	olympia
abba	tinpan
abbey	victorian
abbeydale	millenium
abbeyrd	
abele	
abstract	victorian
acapulco	oasis
accountancy	business
acegarp	tatooine
ackerman	meltingpot
acquisition	business
action	underworld
activex	skyscraper
adams	wembley
adaptec	skyscraper
adobe	skyscraper
adventure	underworld
advertising	business
aerodrome	meltingpot
aesthetic	victorian
afl	olympia
agassi	olympia
agnes	westwood
agnetha	
akabusi	olympia
alabama	meltingpot
alaia	westwood
alameda	meltingpot
alaska	meltingpot
albania	meltingpot
albarn	tinpan
alberni	meltingpot
albert	tinpan
albertsq	
albion	rivendell
album	tinpan
aldiss	tatooine,tattooine
alexandra	meltingpot
alfa	silverstone
alfred	campus
algeria	meltingpot
ali	olympia
all	business
allegro	silverstone
allen	
allergy	healthclub
allnighter	campus
alpha	skyscraper
altavista	skyscraper
am	business
amalfi	littleitaly
ambient	tinpan
amd	skyscraper
amicus	roswell
amsterdam	meltingpot
amused	uproar
analogue	skyscraper
analysis	business
anchor	marina
andersen	tatooine
anderton	wembley
andes	oasis
andorra	meltingpot
andreessen	skyscraper
anfield	
angband	rivendell
angel	boozers
angelic	roswell
angelico	littleitaly
angelo	campus
angels	rivendell
angkor	oasis
angola	meltingpot
anlaby	campus
anschutz	business
anthrax	tinpan
anthropology	campus
aphex	tinpan
apocalypse	lavendar,lavender
apollo	tatooine,tattooine
apple	skyscraper
appleway	tinpan
application	skyscraper
aprilskies	tinpan
aptiva	skyscraper
arabian	
arcadia	underworld
arch	westwood
arecibo	roswell
arena	underworld
argento	roswell
arison	business
arkansas	meltingpot
arkham	roswell
arklow	bally
armada	marina
armani	westwood
armenia	meltingpot
aroma	
arpanet	skyscraper
arrival	rivendell
art	campus
artwork	
asbury	campus
ash	tinpan
ashcroft	tinpan
asimov	tattooine
aspen	oasis
assembley	campus
asteroids	underworld
astrology	roswell
athena	campus
athletes	uproar
atkinson	lavendar,lavender
atlanta	olympia
atlantis	oasis
attenborough	lavendar,lavender
auburn	campus
auditorium	campus
aurora	campus
austen	
austin	silverstone
austral	boozers
austria	
avebury	roswell
average	tinpan
averett	campus
avery	boozers
avila	
avoca	bally
avondale	millenium,millennium
axeman	
ayers	tinpan
aylesbury	millenium,millennium
babar	millennium,millenium
babbage	skyscraper
baberuth	olympia
baccarach	tinpan
backseat	silverstone
backspace	skyscraper
backstrain	
backup	tinpan
bacon	victorian
bahamas	oasis
bahia	oasis
bahrain	meltingpot
bailey	roswell
baked	campus
baker	
bali	oasis
ball	bennyhills
ballard	skyscraper
balleydehob	
ballmer	business
balloons	millennium
band	tinpan
bandicoot	underworld
bandwith	skyscraper
bankbroadway	business
bankhead	millenium,millennium
banking	business
bankrupt	business
bannister	olympia
bantry	bally
banzai	lavender,lavendar
barada	roswell
barbarian	rivendell
barbie	rainbow
barchester	victorian
barclay	meltingpot
bari	littleitaly
bark	petparade
barker	roswell
barnard	boozers
barneyhill	roswell
barnsbury	meltingpot
barr	bennyhills
barry	campus
basic	
bass	business
bassey	tinpan
bassst	business
bates	campus
battlespire	
batty	wembley
baugh	olympia
baxendale	tinpan
baylor	olympia
bear	tatooine,tattooine
beardsley	victorian
beatnik	victorian
beautiful	westwood
beaver	greenfield
bechtel	business
beckenbauer	wembley
beckham	
beegee	tinpan
belarus	
belgium	meltingpot
belhaven	
belize	oasis
bell	boozers
belleek	
bellevue	campus
bellow	victorian
belmont	campus
beluga	greenfield
belushi	
belvedere	victorian
benedict	campus
benidorm	oasis
benin	meltingpot
benjamin	victorian
bennyfive	bennyhills
bennyone	bennyhills
bennythree	bennyhills
bentley	tinpan
benwhite	meltingpot
berkeley	millenium,millennium
bernhard	village
bernini	littleitaly
berry	campus
bertisevil	millenium,millennium
bertone	silverstone
best	olympia
bester	tattooine
bethel	campus
beverly	campus
bicycle	greenfield
bigband	
bigbird	millenium
bigears	millennium,millenium
bigmama	greenfield
billmurray	bennyhills
binary	skyscraper
biology	campus
bird	boozers
birdcage	village
birds	lavender,lavendar
bischoff	olympia
bit	skyscraper
bitmap	skyscraper
black	skyscraper
blackflag	tinpan
blacklion	boozers
blackpool	oasis
blake	victorian
blaster	underworld
blavatsky	roswell
blish	tatooine,tattooine
blondie	tinpan
blood	underworld
bloom	bally
blossom	millenium
blueangel	boozers
bluebell	campus
bluenote	tinpan
bluepeter	millennium,millenium
blueridge	millenium,millennium
blues	
bluesbros	bennyhills
bluffton	campus
blumarine	westwood
blur	tinpan
blythe	meltingpot
blyton	millennium,millenium
bnfl	greenfield
boardgame	
boardman	olympia
boardwalk	tinpan
bobsled	olympia
bologna	littleitaly
bolsover	victorian
bond	
bondi	oasis
bonehead	tinpan
bongos	tinpan
bonhomie	millenium
bonnet	silverstone
bonneville	silverstone
books	campus
boot	silverstone
bootsy	tinpan
borabora	marina
borley	roswell
boss	business
bosses	business
boston	campus
botham	olympia
botswana	meltingpot
botticelli	littleitaly
bounty	marina
boutique	business
bovine	petparade
bowcreek	marina
boxer	healthclub
bp	greenfield
brabham	silverstone
bradbury	skyscraper
bradley	campus
brady	
brainy	uproar
brake	
braker	meltingpot
brambles	victorian
brand	
brandling	
brandshatch	silverstone
brasco	lavendar,lavender
brass	
brazil	lavender,lavendar
brazos	meltingpot
bread	meltingpot
break	skyscraper
breakwater	marina
breed	tinpan
breifcase	business
bren	business
brett	lavendar,lavender
brewerytap	boozers
briarwood	millenium
brickandmortar	business
bridge	boozers
brigham	campus
brighton	oasis
broadway	meltingpot
brodie	meltingpot
bronfman	business
bronte	victorian
brooks	
brown	bennyhills
browning	victorian
browser	skyscraper
brucelee	olympia
bruno	olympia
brush	victorian
brutalist	victorian
bryant	campus
buckingham	victorian
buffett	business
bugfix	
bull	business
bulletproof	underworld
bunnymen	tinpan
buonarotti	littleitaly
burgess	tinpan
burnaby	meltingpot
burns	
burrard	meltingpot
burundi	meltingpot
bus	skyscraper
buseight	business
busfive	business
busfour	business
bush	tinpan
business	campus
busnine	business
busone	business
busseven	business
busthree	business
bustwo	business
bute	meltingpot
butler	bennyhills
buyout	business
buzzard	greenfield
buzzer	bennyhills
byker	millennium,millenium
bypass	greenfield
byrite	
byron	victorian
byte	skyscraper
byzantium	victorian
cable	skyscraper
cache	skyscraper
caelius	rivendell
cairo	skyscraper
cajun	tinpan
calabria	littleitaly
calc	skyscraper
caldwell	campus
caledonia	marina
caledonian	boozers
california	meltingpot
callanish	roswell
caltech	campus
calvin	westwood
cambie	meltingpot
cambodia	oasis
cameron	roswell
cameroon	meltingpot
campden	victorian
canada	meltingpot
canal	victorian
canaveral	tatooine,tattooine
cancun	oasis
candy	bennyhills
candyman	lavender,lavendar
cannes	oasis
canterbury	victorian
canvas	victorian
canyon	oasis
capacity	skyscraper
capote	village
caravaggio	littleitaly
carbon	westwood
carcorner	silverstone
cardgame	underworld
cargill	business
caribbean	marina
carlow	bally
carlton	skyscraper
carmageddon	underworld
carmelita	victorian
carnaby	
carnival	village
carolina	
carpenter	tatooine
carpenters	tinpan
carrey	
carroll	victorian
carson	olympia
carthage	campus
carving	westwood
casablanca	lavender,lavendar
cash	business
casino	lavender
castle	rivendell
castleton	millenium,millennium
cat	greenfield
caterpillar	underworld
cavan	bally
cavendish	meltingpot
caves	
cayecalm	marina
cayman	
cd	tinpan
cdrom	skyscraper
cecilian	meltingpot
cedar	millennium,millenium
celebration	athena
celebrity	uproar
celesteville	millennium,millenium
celluloid	
centerport	meltingpot
centre	skyscraper
century	skyscraper
ceo	business
cern	skyscraper
cerruti	westwood
cesena	littleitaly
cezanne	victorian
chad	meltingpot
chalk	westwood
challenger	tatooine,tattooine
chamberlain	olympia
champion	meltingpot
champlain	campus
chanel	westwood
chaney	roswell
channeling	roswell
chaos	skyscraper
chaplin	bennyhills
chapman	bennyhills
charcoal	victorian
cheatcode	underworld
chelmsford	lavendar,lavender
chemical	tinpan
chemistry	campus
cheshire	boozers
chevy	silverstone
chevychase	bennyhills
cheyne	victorian
chicane	silverstone
chicken	
chicon	meltingpot
chile	meltingpot
china	meltingpot
chinatown	
chisel	westwood
chloe	westwood
choose	millennium,millenium
chorus	tinpan
christian	marina
christie	olympia
christy	victorian
chronos	rivendell
chrysler	silverstone
chucky	underworld
chupacabras	roswell
church	victorian
churchmews	victorian
circus	millennium,millenium
clap	tinpan
clapham	village
clapton	tinpan
clarion	campus
clarke	tattooine,tatooine
classical	victorian
clay	bennyhills
clearstreets	greenfield
cleese	bennyhills
clemson	campus
cliff	tinpan
clint	lavender,lavendar
clinton	tinpan
clockwork	lavender,lavendar
cloisters	victorian
club	oasis
clubmed	oasis
cluster	tatooine,tattooine
clutch	silverstone
clyde	meltingpot
coachandhorses	boozers
coalbrook	bally
coax	skyscraper
cobain	tinpan
cobb	olympia
cock	
cockatiel	petparade
coconut	marina
code	skyscraper
coding	skyscraper
coe	olympia
coinop	underworld
coldcut	tinpan
coldwater	victorian
cole	underworld
college	
collingwood	boozers
collins	tinpan
colombia	
coltrane	bennyhills
columbia	campus
comaneci	olympia
commodity	marina
communion	roswell
compaq	skyscraper
compiler	
computer	business
computerplace	campus
computing	campus
concert	
congo	meltingpot
congress	meltingpot
connemara	
connery	lavender,lavendar
conolly	bennyhills
console	underworld
conspiracy	roswell
constantine	tattooine
continue	underworld
controlpad	underworld
conundrum	uproar
conway	victorian
coop	victorian
copland	skyscraper
copyright	skyscraper
corel	skyscraper
cork	bally
corleone	littleitaly
cornell	campus
coronation	
corridors	underworld
cosanostra	
cosmo	uproar
costello	tinpan
cosworth	silverstone
cottingham	campus
country	
court	meltingpot
covent	meltingpot
cowley	silverstone
cozumel	oasis
cpr	healthclub
crackingup	bennyhills
cranley	meltingpot
crawdad	greenfield
cray	skyscraper
crayon	victorian
creativity	westwood
creators	campus
credit	business
cremona	littleitaly
crescent	victorian
crisis	rivendell
croatia	meltingpot
croft	underworld
cromwell	rivendell
crosshair	underworld
crowley	roswell
crown	business
crownanchor	boozers
crusty	tinpan
crystal	roswell
cslewis	millenium,millennium
cuba	oasis
cubist	victorian
culture	tattooine,tatooine
cumberland	meltingpot
curie	
curse	rivendell
curtin	bennyhills
cushing	roswell
customhouse	marina
cut	westwood
cutiepie	millennium
cuttysark	marina
cyberpunk	rivendell
cyburbia	skyscraper
cycle	
cyprus	marina
cyrix	skyscraper
dada	victorian
dadd	victorian
daddio	victorian
daggerfall	rivendell
daihatsu	silverstone
daisywheel	skyscraper
dakota	
dale	lavendar,lavender
dali	victorian
dalston	meltingpot
damonhill	silverstone
dana	campus
dance	athena
daniken	roswell
dante	victorian
dark	rivendell
darkearth	rivendell
darkforces	underworld
darkknight	tatooine,tattooine
darkness	rivendell
dartmouth	campus
data	skyscraper
database	skyscraper
davenport	campus
david	business
davidson	campus
davinci	littleitaly
davincidr	
davis	tinpan
davros	tattooine
dawson	campus
daytona	silverstone
deadhead	tinpan
deadparrot	bennyhills
deal	business
dean	olympia
deathrace	lavender
dechirico	littleitaly
decimal	skyscraper
deckard	tattooine,tatooine
deckarddr	
deer	petparade
deercreek	greenfield
defender	underworld
defiant	campus
degas	victorian
degeneres	village
del	business
delacroix	victorian
delany	tattooine,tatooine
dell	wembley
dellapiero	
delta	campus
demons	rivendell
dempsey	olympia
den	wembley
denison	campus
denman	meltingpot
denmark	
depaul	campus
derby	
descent	underworld
deschutes	skyscraper
design	campus
desk	business
desktop	skyscraper
detomaso	silverstone
deva	roswell
diablo	rivendell
diamond	athena
diaz	lavender,lavendar
dick	tattooine,tatooine
diet	healthclub
digital	skyscraper
digitalstreet	underworld
dilbert	
dillard	campus
dimaggio	olympia
dingle	bally
dinosaur	rainbow
dior	westwood
dipsy	millennium,millenium
director	business
discount	business
discus	olympia
disk	skyscraper
disney	rainbow
diva	village
divination	roswell
dixie	campus
dj	tinpan
dns	skyscraper
doane	campus
dockers	marina
doddington	millennium,millenium
dog	
dogbreeder	business
dogdayz	millenium,millennium
dolce	westwood
dolls	lavendar,lavender
dolomite	lavender
dolphin	
dominica	meltingpot
donahue	victorian
donald	millennium,millenium
donatello	littleitaly
donegal	bally
dongiovanni	littleitaly
donkeykong	underworld
doo	bennyhills
doom	underworld
doomdr	
doowop	tinpan
dopehead	tinpan
dorisday	village
dorms	
dos	skyscraper
doubleneck	tinpan
doug	bally
douglas	lavendar,lavender
doveside	meltingpot
dowling	campus
download	skyscraper
downshift	silverstone
dowsing	roswell
drag	silverstone
dragon	boozers
dragonball	underworld
drake	tinpan
dramatic	campus
dreadlock	tinpan
dreams	greenfield
dredd	tattooine,tatooine
dress	westwood
drew	
drexel	campus
drive	skyscraper
drongo	greenfield
dropout	campus
druid	roswell
drumandbass	tinpan
drummer	tinpan
drummonds	boozers
druru	campus
dsldrive	skyscraper
dublin	bally
duchamp	victorian
duck	
ducksoup	lavender,lavendar
duke	campus
dukenukem	underworld
dungeon	rivendell
dunsmuir	meltingpot
duquesne	campus
durer	victorian
durham	boozers
durrus	bally
dusk	lavender,lavendar
dwellers	greenfield
dylan	tinpan
dynamic	skyscraper
e1	emachines
e10	emachines
e11	emachines
e12	emachines
e2	emachines
e3	emachines
e4	
e6	emachines
e9	emachines
eagle	meltingpot
eagles	greenfield
ear	tinpan
earhart	athena
earlham	campus
east	meltingpot
easter	skyscraper
eastindia	marina
eastwood	lavendar,lavender
easy	tinpan
easystreeit	
easystreet	business
ebony	tinpan
eclipse	
eco	greenfield
ecolodge	greenfield
ecommerce	business
economics	campus
ecuador	
edit	skyscraper
edward	
edwood	tattooine,tatooine
egret	greenfield
egypt	meltingpot
einstein	campus
electric	tinpan
electrical	campus
elephant	boozers
elfin	rivendell
elfman	bennyhills
eliot	victorian
elland	wembley
ellerburn	millenium
ellington	tinpan
ellison	tattooine,tatooine
ellrd	business
elm	roswell
elmst	
elpaso	meltingpot
eltonjohn	tinpan
elystan	lavendar
emacs	skyscraper
email	skyscraper
embankment	marina
emerald	athena
empiriana	rivendell
empowerment	athena
empress	boozers
emulator	underworld
enfield	meltingpot
engine	silverstone
engineers	campus
english	campus
enigma	skyscraper
eno	tinpan
epson	skyscraper
equality	village
equestrian	petparade
eraserhead	lavender,lavendar
eritrea	
escape	underworld
essay	campus
essex	victorian
estonia	meltingpot
etch	westwood
etheridge	village
ethernet	skyscraper
ethiopia	meltingpot
eudora	skyscraper
eventhorizon	tatooine,tattooine
everquest	rivendell
evil	
evildead	lavendar,lavender
ewok	tatooine,tattooine
ewood	wembley
excession	tattooine,tatooine
executive	business
exercise	athena
exeter	meltingpot
exorcist	lavender
f22	underworld
fable	rivendell
fair	campus
fairview	millenium
faithfull	tinpan
falcon	tatooine,tattooine
faldo	olympia
fallout	rivendell
falmouth	millennium
family	millennium
fantasy	marina
farhi	westwood
farley	meltingpot
farmer	tattooine
farmers	boozers
fascination	
fashion	athena
fashoinave	westwood
fastlane	
fatbit	skyscraper
fatboy	tinpan
fatcat	greenfield
fate	roswell
fatima	tinpan
fawlty	bennyhills
fax	business
fdisk	skyscraper
feather	athena
feature	
feminism	athena
fermanagh	bally
ferndale	victorian
ferrari	silverstone
ferret	boozers
fiat	silverstone
fifa	underworld
fig	millenium
fiji	meltingpot
filbert	wembley
filippo	littleitaly
filthyrich	business
final	rivendell
finalfantasy	underworld
finance	business
fingerclick	tinpan
finishing	
finisterre	marina
finland	meltingpot
finsbury	
fire	rivendell
fireforge	rivendell
firelli	skyscraper
firemansam	millennium,millenium
fireside	rivendell
fish	greenfield
fisher	
fishermans	marina
fishing	marina
fitzgerald	tinpan
flamingo	greenfield
flamingos	lavender
flavour	
fleming	business
florence	littleitaly
flotation	business
flower	bennyhills
flowered	tinpan
floyd	tinpan
fluke	tinpan
flute	tinpan
flytrap	
footman	boozers
foottap	tinpan
forbidden	tattooine
foreshore	marina
format	skyscraper
fortune	skyscraper
foster	village
fowler	olympia
fowles	victorian
foxtrotfields	tinpan
foxybrown	lavender,lavendar
fpoint	skyscraper
france	meltingpot
frankenstein	lavender,lavendar
frat	campus
freedom	village
freelife	underworld
french	campus
freud	victorian
fribourg	business
friday	lavender
friendly	campus
frog	marina
fuel	silverstone
fulbourne	lavender,lavendar
fullmonty	lavender,lavendar
funk	tinpan
funkadelic	tinpan
funnycar	silverstone
funnywalk	bennyhills
funtime	
furball	petparade
furcadia	rivendell
gabbana	westwood
gabon	meltingpot
gains	tinpan
galaxian	underworld
galaxy	uproar
galaxyway	
gallagher	tinpan
galleon	marina
gallery	westwood
galliano	westwood
gallows	rivendell
galway	bally
gambia	
gameover	underworld
gamers	rivendell
gamerszone	
gamescene	
gangsta	tinpan
gap	business
garage	silverstone
garden	greenfield
gargoyle	tatooine,tattooine
garland	village
garr	
garston	millenium,millennium
gascoign	olympia
gasoline	silverstone
gateway	
gaugin	
gauguin	victorian
gear	silverstone
geffen	business
gehrig	olympia
geiger	victorian
genesis	underworld
geography	campus
george	victorian
georgebest	boozers
georgia	meltingpot
germany	
gernsback	tattooine,tatooine
gettings	campus
ghana	meltingpot
ghost	westwood
gibson	tattooine,tatooine
gibsongr	
gigahertz	skyscraper
giggs	olympia
gigo	skyscraper
gilford	meltingpot
gilliams	lavender,lavendar
ginger	
ginsberg	athena
giorgio	westwood
giotto	littleitaly
gipsy	meltingpot
girls	athena
givenchy	westwood
glendower	boozers
glue	westwood
goa	oasis
goblins	underworld
goddess	rivendell
godfather	lavender
godzilla	rainbow
gogo	
gold	business
goldberg	olympia
goldendawn	roswell
goldeneye	underworld
goldie	tinpan
golding	victorian
gonda	business
goodboy	millennium
goodfellas	lavender,lavendar
goodgirl	millennium
goodison	wembley
goodnight	business
gordon	silverstone
gosub	underworld
gotham	millennium
gothic	rivendell
goya	victorian
gracious	athena
graduate	campus
gramophone	tinpan
grandprix	
grandtheft	underworld
grange	olympia
grangehill	millenium
grapes	boozers
graphic	campus
graphical	skyscraper
graveyard	skyscraper
greateastern	marina
greater	skyscraper
greatpier	marina
greatsleep	lavendar,lavender
greece	meltingpot
green	meltingpot
greenberg	
greendale	millenium
greene	olympia
greenland	marina
greenlawn	meltingpot
greenman	boozers
greenside	meltingpot
greenwich	marina
greenwood	meltingpot
gregory	meltingpot
grenada	meltingpot
gretzky	olympia
grimsby	boozers
grizzly	greenfield
groundeffects	silverstone
grove	meltingpot
growing	millenium,millennium
growth	business
grunge	tinpan
guadelupe	meltingpot
guam	meltingpot
gucci	westwood
guerlain	westwood
guinea	
guinness	bally
guitar	tinpan
gulf	oasis
gum	bennyhills
gunnell	olympia
gutbuster	bennyhills
guyana	
gym	healthclub
gypsy	roswell
gypsyboys	
haas	business
hackers	
hahat	tinpan
haight	tinpan
haiti	meltingpot
hal	tattooine,tatooine
halebopp	roswell
halley	tattooine,tatooine
halloween	lavendar,lavender
halojones	tatooine,tattooine
hamilton	skyscraper
hammer	roswell
hammond	tinpan
hampton	victorian
hancock	village
handcrafts	business
handheld	underworld
hangar	
hanley	olympia
happy	millennium,millenium
harbor	marina
harbour	marina
harbourside	marina
harddrive	
hardhouse	tinpan
harding	olympia
hardy	bennyhills
harms	
harp	bally
harris	victorian
harrison	tinpan
harrow	meltingpot
harrys	boozers
hartford	victorian
harvard	campus
harvester	rivendell
hastings	meltingpot
havana	marina
hawkins	
hawks	greenfield
hawkslane	lavendar,lavender
hawn	bennyhills
hawtrey	village
headfort	meltingpot
headroom	skyscraper
healey	silverstone
healing	greenfield
health	rivendell
hearst	business
heat	lavendar,lavender
heath	village
heinlein	tattooine,tatooine
heisman	olympia
hellblazer	tatooine,tattooine
hellraiser	lavender,lavendar
helmet	silverstone
hemingford	boozers
henchman	rivendell
herbert	tatooine,tattooine
hermes	westwood
hero	rivendell
heron	marina
hexen	underworld
hexplore	rivendell
hibernium	millenium
hibiscus	millenium,millennium
hickory	
hicks	bennyhills
hiddenlevel	
hifi	tinpan
highbury	wembley
highburyway	meltingpot
highfield	wembley
highlight	
highrise	skyscraper
highschool	campus
highseas	marina
highstreet	village
highwater	marina
highwayman	rivendell
hill	olympia
hillbridge	silverstone
hillcrest	victorian
hillfiger	westwood
hillman	business
hillsborough	wembley
hindmarsh	millenium,millennium
hiphop	tinpan
hirez	skyscraper
hiscore	underworld
history	campus
hitchcock	lavendar,lavender
hitech	rainbow
hobbies	
hobbit	rivendell
hobgoblin	rivendell
hockey	healthclub
hoddle	wembley
hogan	olympia
holbein	victorian
hollyoaks	millenium,millennium
holygrail	bennyhills
honduras	meltingpot
hong	meltingpot
hooper	roswell
hope	bennyhills
hopley	campus
horn	boozers
hornblower	marina
hornchurch	marina
hornsey	meltingpot
hornton	victorian
horserider	rivendell
hoskins	lavendar,lavender
hotel	tinpan
hound	petparade
house	
howdee	westwood
howe	olympia
howlow	uproar
hudson	skyscraper
hudsucker	skyscraper
huizenga	business
hull	campus
huma	rivendell
hummingbird	greenfield
humperdinck	tinpan
hungary	meltingpot
hunt	business
hunters	greenfield
huntington	meltingpot
huntsford	silverstone
huntsman	business
hurst	victorian
hyde	roswell
hymn	victorian
hysterical	bennyhills
ibrox	wembley
icahn	business
icecream	rainbow
iceland	meltingpot
idea	westwood
idle	bennyhills
illinois	meltingpot
illusions	lavender
image	
immortal	rivendell
imola	silverstone
impact	underworld
impala	silverstone
imran	olympia
ince	olympia
indemnity	lavender,lavendar
india	meltingpot
indiabasin	marina
indiana	meltingpot
influence	business
ingram	business
ink	campus
inner	skyscraper
integer	skyscraper
interest	business
inutero	tinpan
investment	business
invincible	marina
ipo	business
ireland	
ironbridge	millennium,millenium
irving	olympia
isaac	westwood
isp	skyscraper
israel	meltingpot
issigonis	silverstone
italian	westwood
italy	meltingpot
ivory	
izzard	bennyhills
jabba	tattooine
jacklin	olympia
jacobean	victorian
jaguar	silverstone
jam	tinpan
jamaica	marina
james	tinpan
jamesdean	village
jamestown	millenium,millennium
jamie	millennium
japan	meltingpot
jarman	lavender,lavendar
jarrett	tinpan
java	skyscraper
jazz	tinpan
jedi	
jekyll	roswell
jelly	
jellyfish	meltingpot
jensen	silverstone
jericho	meltingpot
jerningham	lavender,lavendar
jerusalem	boozers
jett	village
jillcourt	meltingpot
jimmys	boozers
jinx	
jive	tinpan
jivestreet	
jm	
joanofarc	athena
jobbs	skyscraper
jock	
jodrell	roswell
jogging	healthclub
johnette	tinpan
johns	business
johnson	olympia
jones	bennyhills
joolsholland	tinpan
jordan	olympia
joyce	bally
joystick	skyscraper
joystickstreet	underworld
judidench	lavendar,lavender
justin	meltingpot
jv	business
kahn	bennyhills
kahuna	boozers
kain	olympia
kamimura	meltingpot
kane	lavendar,lavender
kansas	meltingpot
kapoor	victorian
karan	westwood
karloff	roswell
kaufman	
kdlane	village
keaton	bennyhills
keepers	rivendell
keillor	victorian
kender	rivendell
kensington	
kentish	meltingpot
kenya	
kerkorian	business
kermit	millenium,millennium
kerrigan	olympia
kerry	
kes	meltingpot
keywest	oasis
kibble	millenium
kickbox	olympia
kildare	bally
kilkenny	bally
kilkennys	boozers
killer	underworld
killiney	bally
king	roswell
kingfisher	marina
kings	meltingpot
kingston	victorian
kirk	tattooine,tatooine
kirkland	meltingpot
kirkwall	millennium,millenium
klamath	skyscraper
klein	
klf	tinpan
klien	victorian
klimt	victorian
kluge	business
kneeslapper	bennyhills
knight	business
knights	rivendell
knitting	westwood
koch	business
koufax	olympia
kowalski	tinpan
kraftwerk	tinpan
krondor	rivendell
krynn	rivendell
kryten	
kungfu	underworld
kurtwood	tinpan
kuwait	meltingpot
kylie	tinpan
labrador	petparade
labreya	oasis
lace	athena
lacroix	westwood
ladder	underworld
ladysmith	meltingpot
lager	
lagerfeld	westwood
lair	rivendell
lala	millennium,millenium
lamar	meltingpot
lamprey	greenfield
lancia	silverstone
landlord	campus
lansdowne	boozers
laos	meltingpot
laptop	
laser	skyscraper
lassie	millenium,millennium
latin	tinpan
latvia	meltingpot
laudanum	tinpan
lauder	business
laugh	bennyhills
laughing	bennyhills
laur	business
laurel	
lauren	westwood
lavender	lavendar,lavender
lavenderplace	millennium
laver	olympia
law	campus
lawless	village
lawns	campus
lawrence	meltingpot
lead	skyscraper
leadbeater	roswell
leader	
leary	bennyhills
lebanon	meltingpot
leehigh	roswell
lefanu	roswell
leftback	campus
legacy	rivendell
legend	rivendell
legends	boozers
legions	rivendell
leguin	tattooine
leiber	tattooine,tatooine
leitrim	bally
lemans	silverstone
lemieux	olympia
lemon	silverstone
lennon	tinpan
lennybruce	bennyhills
leo	greenfield
leonard	tinpan
lerner	business
lesaux	wembley
lesotho	
lessthan	skyscraper
letissier	wembley
level	underworld
lewis	olympia
lexington	victorian
lexus	silverstone
liberia	meltingpot
liberty	meltingpot
library	campus
libya	meltingpot
liceladder	tinpan
licence	silverstone
lidden	meltingpot
lifeforms	tinpan
lightsey	
lightyear	millenium
lilac	millennium,millenium
lily	millenium,millennium
limerick	bally
lincoln	millenium,millennium
line	westwood
lingerie	westwood
linux	skyscraper
lion	victorian
lions	rainbow
lipinsky	olympia
literary	victorian
lithium	tinpan
lithuania	
liveoak	
livorno	littleitaly
liz	skyscraper
loadedave	tinpan
loading	underworld
lobo	olympia
lodge	meltingpot
loftus	wembley
lol	skyscraper
lolos	boozers
lombard	
lonely	
longford	bally
longmark	marina
loselane	business
lotus	silverstone
louganis	olympia
louth	bally
louvre	victorian
lovecraft	roswell
lowfi	
lowrez	skyscraper
loxwood	lavendar,lavender
lsat	
lucar	business
lucas	tatooine,tattooine
lucky	rivendell
lufia	rivendell
luge	olympia
lumley	lavender,lavendar
lumpy	meltingpot
lunar	rivendell
lunchbox	millenium,millennium
lute	tinpan
lycos	skyscraper
lylat	underworld
lynch	village
lynx	skyscraper
macau	meltingpot
macdonalds	greenfield
machievelli	littleitaly
machu	oasis
macro	skyscraper
macy	westwood
madden	olympia
mage	rivendell
magic	millennium,millenium
magician	rivendell
maiden	
mainbrace	marina
maine	wembley
makefile	
makeover	westwood
malawi	meltingpot
malaysia	meltingpot
malcolms	westwood
maldives	
mali	meltingpot
malibu	oasis
malone	olympia
malt	millenium,millennium
malta	meltingpot
malthops	
management	athena
manager	business
manatee	marina
manchaca	meltingpot
manchester	greenfield
mandela	campus
manet	victorian
manic	skyscraper
manicstreet	tinpan
manning	olympia
manor	meltingpot
mansell	silverstone
manwood	lavendar
maple	greenfield
mapplethorpe	
maradona	olympia
marathon	underworld
marble	millennium,millenium
mardigras	village
margaret	victorian
marge	
marimba	tinpan
marine	marina
mario	underworld
marketing	business
marquisgranby	boozers
marrakesh	oasis
marriage	athena
marriott	business
mars	business
marshall	campus
marshalls	business
martin	bennyhills
martina	village
martinist	roswell
mason	campus
masonic	roswell
masquerade	rivendell
massive	tinpan
maths	campus
matrox	skyscraper
maupin	village
mauritius	oasis
mayall	bennyhills
mayflower	boozers
mayo	bally
mayotte	meltingpot
mays	olympia
mccaffrey	tattooine,tatooine
mccartney	tinpan
mccaw	
mcenroe	olympia
mcmahon	olympia
mcnastys	boozers
mcqueen	westwood
mdk	underworld
mdmotels	
meadow	greenfield
meadowbank	millenium,millennium
meangene	olympia
meanie	skyscraper
meath	bally
meatloaf	tinpan
media	campus
mediastreet	business
medical	healthclub
medicine	campus
megabyte	skyscraper
mehetebell	victorian
melbourne	meltingpot
melody	tinpan
melrose	
melwood	meltingpot
memo	skyscraper
memocorner	business
memorial	victorian
memory	skyscraper
memphis	skyscraper
mental	uproar
mercedes	silverstone
mercury	tinpan
merger	business
meridian	rivendell
merrow	meltingpot
metal	tinpan
metallica	tinpan
metcalf	business
metric	meltingpot
metroid	underworld
mexico	meltingpot
meyer	lavender,lavendar
miami	oasis
michaels	olympia
michelangelo	littleitaly
michigan	meltingpot
micro	skyscraper
middleschool	campus
midler	bennyhills
might	rivendell
milan	westwood
miles	tinpan
milkyway	roswell
mill	victorian
millen	westwood
millenit	skyscraper
millenium	
miller	bennyhills
millionaire	business
milton	victorian
mime	skyscraper
minelli	
minesweeper	underworld
mingus	tinpan
minnesota	
minnetonka	roswell
minogues	bally
missile	meltingpot
mission	underworld
missouri	meltingpot
mitchell	business
mitchum	lavender,lavendar
mlk	meltingpot
mmx	skyscraper
mnemonic	skyscraper
mockingbird	lavender,lavendar
modem	skyscraper
modemmews	
modena	littleitaly
module	skyscraper
moldova	meltingpot
moma	victorian
momandpop	business
mommy	millenium
monaco	oasis
mondo	skyscraper
money	business
mongolia	meltingpot
monitor	
monkeys	lavender,lavendar
monster	
montagna	littleitaly
montana	olympia
montego	oasis
montgomery	village
montopolis	meltingpot
montserrat	
moo	business
moonlight	tinpan
moorcock	tatooine,tattooine
moore	bennyhills
mordor	rivendell
morgan	silverstone
moria	rivendell
morningstar	rivendell
morocco	meltingpot
morris	bennyhills
morrison	tinpan
morrissey	tinpan
mortalkombat	underworld
mosaic	westwood
moschino	westwood
mosside	silverstone
mother	greenfield
motherhood	athena
mothership	tattooine,tatooine
motherteresa	athena
motorhead	tinpan
motorola	skyscraper
mouse	
mousepad	skyscraper
mozilla	skyscraper
mrbean	bennyhills
mud	underworld
mudhoney	tinpan
mudhouse	marina
mueller	wembley
mugler	westwood
mulder	skyscraper
mulligan	bally
mulligans	boozers
multiplayer	underworld
multisports	underworld
murdoch	business
murphy	bennyhills
murray	silverstone
muscle	oasis
muses	victorian
museum	victorian
musical	tinpan
muswell	lavendar,lavender
myanmar	meltingpot
myrtle	oasis
myst	underworld
mystery	underworld
mysticmeg	roswell
myway	tinpan
naked	westwood
namibia	
napier	business
nasa	rainbow
naseem	olympia
nash	olympia
nathan	
navan	bally
navarino	meltingpot
nebraska	meltingpot
neches	meltingpot
necronomicon	roswell
neil	skyscraper
nelson	marina
nemesis	rivendell
nepal	meltingpot
networking	skyscraper
nevada	meltingpot
neverhood	rivendell
nevermind	tinpan
newbonham	tinpan
newchurch	millenium,millennium
newcompton	village
newengland	tinpan
newhouse	business
newland	marina
newlandavenue	campus
newreed	tinpan
newton	campus
nexus	
niagara	oasis
nicaragua	meltingpot
nice	oasis
nicholas	business
nicklaus	olympia
nicola	
nicole	boozers
niger	meltingpot
nigeria	meltingpot
nightingale	athena
ninja	
nintendo	underworld
nirvana	tinpan
nitro	
niven	tatooine,tattooine
nj	meltingpot
norfolk	boozers
normality	
norman	olympia
northumberland	boozers
norway	meltingpot
not	skyscraper
notebook	business
noucamp	wembley
nova	skyscraper
nt	skyscraper
nuclear	skyscraper
null	skyscraper
number	skyscraper
nurmi	olympia
ny	meltingpot
oahu	oasis
oak	
oakland	
oakwell	wembley
oasis	tinpan
obiwan	tattooine
oboe	tinpan
obsidian	rivendell
ocean	tinpan
octopus	meltingpot
oddworld	rivendell
offaly	bally
office	business
offord	meltingpot
oil	silverstone
okeefe	
okehampton	millenium,millennium
old	meltingpot
oldemill	millenium,millennium
oldhouse	boozers
oldman	lavendar
oldsmobile	silverstone
oldsquire	tinpan
oldtown	campus
oltorf	meltingpot
olympic	underworld
oman	meltingpot
online	skyscraper
operatic	victorian
oracle	skyscraper
orange	
orchestra	tinpan
oregon	meltingpot
orlando	village
ormonde	meltingpot
orton	village
orwell	victorian
os2	skyscraper
overdraft	campus
overdrive	skyscraper
ovett	olympia
owen	wembley
oxford	meltingpot
ozarks	oasis
ozbek	westwood
pacific	skyscraper
pacman	underworld
paddington	millennium,millenium
paddock	silverstone
pagemaker	skyscraper
paintbrush	victorian
painting	westwood
pakistan	meltingpot
palace	victorian
palau	meltingpot
palette	victorian
palmers	marina
panama	meltingpot
panda	greenfield
pandemonium	underworld
pankhurst	athena
pantera	silverstone
panthera	greenfield
paradise	oasis
paraguay	meltingpot
parallax	skyscraper
paris	oasis
park	meltingpot
parkhotel	boozers
parklands	meltingpot
parkstreet	victorian
parkwood	victorian
parliament	
parton	tinpan
partridge	meltingpot
party	athena
pascoe	skyscraper
pastel	victorian
patch	skyscraper
patchwork	westwood
paulince	wembley
payton	olympia
peacock	meltingpot
pecan	meltingpot
pele	olympia
pelican	marina
pen	business
pencil	business
pender	meltingpot
penny	tinpan
penthouse	skyscraper
pentium	skyscraper
perelman	
perfect	tinpan
perilith	rivendell
perl	skyscraper
perot	
perry	olympia
peru	meltingpot
perugia	littleitaly
petebest	tinpan
petrol	silverstone
pettruciani	tinpan
phat	
pheasant	boozers
philosophy	roswell
phlebas	tatooine,tattooine
phoenix	village
photoshop	skyscraper
physics	campus
piacenza	littleitaly
piano	tinpan
picasso	victorian
picassopl	
picket	meltingpot
picnic	millennium,millenium
picture	uproar
pictureway	victorian
pier	marina
pierhead	marina
piglet	
pimlico	lavendar,lavender
pinball	underworld
pink	village
pinter	victorian
pipeline	oasis
piper	olympia
pitcairn	marina
pixel	skyscraper
pizza	millenium,millennium
plan9	lavendar,lavender
plastikman	tinpan
platform	
plath	victorian
playdays	millenium,millennium
player1	underworld
playstation	underworld
plumbers	business
plumpton	millennium,millenium
pluto	millenium
po	millenium,millennium
poe	roswell
poetry	victorian
pohl	tattooine
pointone	skyscraper
poitier	lavendar,lavender
poland	meltingpot
polanski	lavendar,lavender
politics	campus
politti	tinpan
pollaiolo	littleitaly
pollock	victorian
polly	tinpan
poltergeist	roswell
pong	underworld
pontiac	silverstone
pontoon	marina
porsche	silverstone
portal	skyscraper
portfolio	victorian
portillo	village
portishead	tinpan
portland	meltingpot
porton	greenfield
portrait	victorian
portugal	
postal	underworld
postmodern	victorian
postoffice	millennium,millenium
pot	campus
potter	millennium
pottery	victorian
powell	lavender,lavendar
power	athena
powercable	skyscraper
powerup	underworld
ppp	skyscraper
prada	westwood
prado	victorian
pratchett	tatooine,tattooine
prediction	roswell
pregnancy	athena
price	roswell
pride	wembley
primate	uproar
princess	rivendell
princessdi	boozers
princeton	campus
principal	millennium
priory	
priscilla	village
pritzker	business
prize	millennium
prodigy	tinpan
profit	greenfield
proops	bennyhills
prophecy	roswell
proxy	skyscraper
psychic	roswell
psycho	lavendar,lavender
psychology	campus
pulpfiction	lavender,lavendar
pump	silverstone
puppet	millennium,millenium
purdue	campus
puzzle	
puzzleplace	millennium,millenium
puzzler	uproar
pyramids	oasis
python	lavendar,lavender
quadra	skyscraper
quantum	skyscraper
quarry	meltingpot
quarrybank	millenium,millennium
quartet	tinpan
quatermass	roswell
queen	tinpan
queenvic	boozers
quickstep	tinpan
quilty	bally
race	underworld
racoon	petparade
radclyffe	village
radiohead	tinpan
radner	bennyhills
rage	tinpan
rainbow	millennium,millenium
raincoat	skyscraper
rainforest	greenfield
raistlin	
ram	skyscraper
rambler	silverstone
rampling	lavendar,lavender
ramsey	
randles	roswell
rap	tinpan
rathdrum	bally
rattler	greenfield
ratty	millenium,millennium
rave	tinpan
raven	greenfield
raytrace	skyscraper
reach	marina
realestate	
realms	rivendell
rearview	silverstone
reception	business
recess	campus
recession	business
reddwarf	bennyhills
redguard	rivendell
redlion	boozers
redmond	skyscraper
redriver	meltingpot
redruth	meltingpot
redstone	business
redwood	millennium,millenium
reeves	
reflex	underworld
regent	meltingpot
reinli	meltingpot
relay	olympia
rembrandt	victorian
renault	silverstone
replicant	tattooine
reprazent	tinpan
research	meltingpot
resedit	skyscraper
retro	underworld
reunion	millennium
revolver	tinpan
rhapsody	
rhydin	rivendell
rice	campus
richard	meltingpot
richie	millenium,millennium
richmond	victorian
ridleyford	lavender
ridleyscott	tattooine,tatooine
riff	tinpan
riley	victorian
ringo	tinpan
rings	rivendell
rintintin	millenium
rioroad	tinpan
riot	bennyhills
riven	underworld
river	millennium,millenium
rivers	village
riverside	wembley
riverstown	
riverview	meltingpot
roadie	tinpan
roadrash	underworld
roberts	meltingpot
robson	meltingpot
rocco	westwood
rock	bennyhills
rockbridge	millenium,millennium
rocke	business
rockhudson	village
rockroll	tinpan
rocky	lavender
rodeo	
rodin	victorian
rofl	skyscraper
roker	wembley
rollingacres	millenium,millennium
rom	
roma	littleitaly
romania	
romario	olympia
romrow	skyscraper
ronaldo	olympia
rosaparks	athena
roscommon	bally
rose	millenium,millennium
roseandcrown	
rosieandjim	millenium,millennium
rothko	victorian
rothside	lavender,lavendar
route66	
rowling	business
rpg	underworld
rpm	tinpan
rsi	skyscraper
rubens	victorian
rugrats	millennium,millenium
rumba	tinpan
run	underworld
rundberg	meltingpot
rune	roswell
runningbrook	greenfield
rushdie	victorian
russ	tattooine,tatooine
russell	victorian
rutgers	campus
ruthven	millennium
rwanda	meltingpot
saab	silverstone
safari	millennium,millenium
sagan	tatooine,tattooine
sailormoon	rainbow
saint	rivendell
saintlaurent	westwood
saints	tinpan
saks	westwood
sakura	rivendell
salash	meltingpot
sales	business
sallyride	athena
salmon	marina
salsa	tinpan
salutation	boozers
sammy	
samoa	meltingpot
sampras	olympia
samsplace	boozers
sand	westwood
sander	
sandringham	meltingpot
sanjacinto	meltingpot
sanpedro	marina
sansiro	wembley
santana	tinpan
sat	millennium,millenium
satin	athena
saturn	silverstone
savannah	millennium,millenium
save	skyscraper
savings	
scanner	skyscraper
scaramouche	lavender,lavendar
scarface	lavender,lavendar
scooby	millenium,millennium
score	tinpan
scsi	skyscraper
scullyst	
sculpture	westwood
sculptured	victorian
seabright	meltingpot
seafarer	marina
seagate	skyscraper
seagull	marina
seaman	olympia
seance	roswell
searchers	lavender
seatbelt	silverstone
seaview	marina
secret	underworld
seinfeld	bennyhills
selhurst	
sellers	bennyhills
senegal	meltingpot
senna	olympia
sensible	tinpan
sentient	rivendell
seque	skyscraper
servalan	tattooine,tatooine
sesame	millennium,millenium
seurat	victorian
seychelles	oasis
seymour	meltingpot
shadows	rivendell
shaft	lavender
shakespeare	campus
shalimar	rivendell
shangri	
shannon	bally
shaq	olympia
shares	business
shark	marina
shearer	olympia
shell	greenfield
shelly	roswell
sheppard	lavender,lavendar
sherwood	millenium
ship	boozers
shirley	tattooine,tatooine
shoemaker	olympia
shootout	underworld
shoreside	marina
shorty	lavendar,lavender
sidekick	tinpan
sidjames	lavender,lavendar
siena	littleitaly
sigfile	skyscraper
silbury	roswell
siliconex	skyscraper
siliconvalley	skyscraper
sillyface	millenium,millennium
silver	silverstone
silverberg	tatooine
sim	underworld
simak	
simcity	underworld
simmons	village
simplot	business
simpson	olympia
simulator	underworld
sinbad	
singapore	meltingpot
singe	uproar
singer	tinpan
single	tinpan
siren	roswell
sister	athena
sitar	tinpan
sitcom	bennyhills
skegness	oasis
sketch	westwood
skip	millennium
skipjunction	meltingpot
skipper	marina
skull	bally
skulls	roswell
skully	skyscraper
skyliner	skyscraper
skylon	skyscraper
slaine	tatooine,tattooine
sligo	bally
slim	tinpan
slope	campus
slovakia	meltingpot
slovenia	meltingpot
slug	boozers
smiles	millennium
smiley	skyscraper
smith	westwood
smoothsailing	marina
snowboard	
soccer	wembley
soda	millennium
solarcity	skyscraper
solaris	skyscraper
soldier	rivendell
solidgold	
solo	skyscraper
solomon	skyscraper
somalia	meltingpot
song	victorian
songbird	
sonic	underworld
sonicst	
sorcerer	rivendell
sorenson	business
sorority	campus
soros	business
sound	tinpan
soundcard	underworld
southend	oasis
southpark	bennyhills
southsea	marina
southwater	millenium,millennium
spaceinvader	underworld
spain	
spanish	campus
speed	
spell	rivendell
spells	roswell
spice	
spicegirls	tinpan
spicewood	
spiderman	
spielberg	tatooine,tattooine
spiff	skyscraper
spinaltap	lavender,lavendar
spinnaker	marina
spock	tattooine
sports	uproar
springbank	campus
springdale	meltingpot
springfield	rainbow
springhill	meltingpot
sputnik	tatooine
sql	skyscraper
srilanka	meltingpot
staff	business
stage2	underworld
stamford	wembley
standup	bennyhills
stanford	victorian
stanmer	victorian
starcraft	underworld
stark	meltingpot
starr	tinpan
startup	business
stassney	meltingpot
static	skyscraper
statue	victorian
statuepark	meltingpot
steel	tinpan
steer	silverstone
stelmo	meltingpot
stephenson	tatooine,tattooine
steps	boozers
sterling	skyscraper
stevenson	skyscraper
sthelena	meltingpot
stilllife	victorian
sting	olympia
stirling	silverstone
stjames	wembley
stlucia	oasis
stmartins	westwood
stock	business
stockport	wembley
stoker	victorian
stokes	roswell
stone	victorian
stonecold	
stonekeep	rivendell
stoneplace	westwood
stonetemple	tinpan
stonewall	village
storey	westwood
stradbroke	lavender,lavendar
straif	underworld
straightman	bennyhills
strand	marina
strangelove	lavendar,lavender
strategy	underworld
strato	
straylight	skyscraper
streetfighter	underworld
streetsharks	millennium,millenium
streiber	roswell
stress	
stroheim	lavendar,lavender
strum	tinpan
studebaker	silverstone
student	campus
study	campus
studygroup	campus
stunt	underworld
sturgeon	tattooine
suburb	millennium,millenium
success	business
sudan	meltingpot
suede	tinpan
suikoden	rivendell
suite	
summit	victorian
sun	skyscraper
sunnyside	millennium,millenium
sunplace	skyscraper
sunra	tinpan
sunroof	silverstone
sunscreem	tinpan
sunshine	greenfield
supergrass	tinpan
surf	
suriname	meltingpot
susileib	westwood
susumi	skyscraper
sutcliffe	tinpan
svalbard	meltingpot
swallowtail	greenfield
swampthing	tattooine,tatooine
swampy	greenfield
swaziland	meltingpot
sweden	meltingpot
sweetvalley	millenium,millennium
swing	tinpan
switch	
sword	rivendell
sydenham	lavendar,lavender
syracuse	campus
syria	meltingpot
systems	skyscraper
t1000	tattooine,tatooine
tactic	underworld
tahoe	oasis
taiwan	meltingpot
takeover	business
tallow	bally
tamborine	tinpan
tanis	rivendell
tarantino	lavender,lavendar
tarot	roswell
taunton	millenium,millennium
tax	business
taylor	business
tcpip	skyscraper
teacher	campus
techie	skyscraper
techno	
technology	business
tekken	rivendell
telephone	business
teletubby	millennium,millenium
telnet	skyscraper
temple	skyscraper
tenison	meltingpot
tennis	healthclub
tenuda	
tequila	boozers
terabyte	skyscraper
termination	underworld
terminus	skyscraper
tetris	underworld
tft	skyscraper
thailand	meltingpot
thames	marina
tharg	tatooine
thatcher	athena
thepits	silverstone
thermin	
threekings	boozers
thrise	skyscraper
thumbnail	victorian
thunder	marina
thundercrack	lavender,lavendar
thurlow	meltingpot
thx1138	tattooine
tiamat	rivendell
tidal	marina
tiepolo	
tiffany	victorian
tiger	greenfield
tigerlilies	tinpan
tigger	rainbow
tigris	greenfield
tilden	olympia
timelapse	
tinkywinky	millenium
tintoretto	littleitaly
tipperary	bally
tisch	business
titanic	marina
toads	millennium
tobago	meltingpot
togo	meltingpot
tolkien	tattooine
tollington	victorian
tomatoes	lavendar,lavender
tombstone	lavender,lavendar
tomlin	
tone	skyscraper
tonga	meltingpot
torvill	olympia
toussard	rivendell
tower	greenfield
toyota	silverstone
track	
trafford	wembley
trance	tinpan
tranquil	marina
transmission	
trash	tinpan
traveller	rivendell
treadmill	healthclub
tree	greenfield
treearbor	millenium
treelee	bally
trees	victorian
trendy	westwood
triangle	boozers
trianglesquare	tinpan
tributary	marina
tricky	tinpan
trinidad	marina
trinity	meltingpot
tripcock	marina
tripper	tinpan
trivia	uproar
troll	rivendell
tropicana	oasis
trousers	lavendar,lavender
true	skyscraper
trumpet	skyscraper
trumpetavenue	tinpan
tuba	tinpan
tulip	millenium
tune	tinpan
tunisia	meltingpot
tupac	tinpan
turing	skyscraper
turkey	meltingpot
turn	business
turner	village
turnpike	lavender,lavendar
turntable	tinpan
turtle	boozers
turvey	campus
tuscan	littleitaly
tuscany	oasis
tvr	silverstone
twain	victorian
twyford	greenfield
tylerbridge	tinpan
tyre	silverstone
tyrell	skyscraper
uccello	littleitaly
uganda	meltingpot
uhura	tattooine,tatooine
ukraine	meltingpot
ullman	
ultima	rivendell
umbria	littleitaly
underpass	
undertaker	olympia
underwood	olympia
underworld	tinpan
unitas	olympia
university	victorian
unix	skyscraper
unreal	rivendell
updike	victorian
upgrade	
uplands	lavender
upper	meltingpot
uproar	uproar
upsidedown	boozers
utah	
vacation	millennium,millenium
valley	
valve	skyscraper
vampire	rivendell
vandaemen	silverstone
vanishing	tinpan
vanthal	roswell
vassar	campus
vatican	littleitaly
vc	business
vegas	oasis
velvet	athena
venice	oasis
verdant	greenfield
vermeer	victorian
verona	victorian
versace	westwood
verse	
verve	tinpan
vibe	tinpan
victory	marina
vietnam	meltingpot
villa	wembley
villageplace	village
villiers	victorian
vine	greenfield
vines	boozers
violin	tinpan
virgin	oasis
virginia	meltingpot
virtuality	underworld
virtuosity	
visionquest	athena
vitamin	healthclub
vivienne	westwood
voltron	
volunteer	boozers
vonnegut	tattooine,tatooine
vortex	roswell
vuitton	westwood
wacky	millenium,millennium
wade	olympia
wagner	olympia
wailing	tinpan
waitt	business
walkers	
wallstreet	business
walton	business
wanderers	rivendell
warcraft	underworld
wargames	lavendar,lavender
warhammer	rivendell
warminster	roswell
warrior	rivendell
washington	business
watchmen	tatooine
waterboys	tinpan
waterford	bally
waterloo	tinpan
wav	skyscraper
waves	marina
wax	westwood
weah	olympia
weaver	village
weekender	tinpan
weightlifter	
wellerville	tinpan
wells	roswell
westbridge	lavender
westferry	marina
westgate	meltingpot
westindia	marina
westmeath	bally
westside	lavender,lavendar
westsound	marina
wexford	bally
wexner	business
wheelsway	silverstone
wheyland	meltingpot
whistle	westwood
whistler	victorian
whitburn	meltingpot
whitby	boozers
white	olympia
whitecat	boozers
whitehart	boozers
whitehartlane	wembley
whiteheart	campus
whittle	business
wigstock	village
wildbill	lavender,lavendar
wildbunch	lavendar,lavender
wilde	village
wilderness	greenfield
wilhelm	tatooine,tattooine
williams	village
williamson	tatooine,tattooine
willis	lavendar,lavender
willows	greenfield
wills	boozers
wilson	bennyhills
wimbledon	
window	silverstone
windows	skyscraper
windsor	village
winelodge	boozers
winners	uproar
winterson	village
wiper	silverstone
wired	skyscraper
wisconsin	meltingpot
witches	roswell
wizard	rivendell
wolf	greenfield
wolfpac	olympia
wongfoo	village
woodcut	victorian
woodhaven	meltingpot
woods	olympia
woodsman	
woodwind	tinpan
woody	millennium,millenium
wooton	victorian
world	rivendell
worldsend	boozers
worms	underworld
wright	bennyhills
wrigley	business
wuthering	tinpan
wyndham	tatooine,tattooine
wyoming	meltingpot
xanadu	village
xanth	rivendell
xentar	rivendell
xwing	underworld
y2k	skyscraper
yale	campus
yellow	
yellowstone	oasis
yemen	meltingpot
yeshiva	campus
yoda	tattooine,tatooine
yosemite	oasis
youghal	bally
zagato	
zaire	meltingpot
zambia	meltingpot
zatopek	olympia
zbar	boozers
zebedee	millenium,millennium
zelazny	tatooine,tattooine
zelda	rivendell
zell	business
zenith	tatooine,tattooine
zennor	marina
zeros	skyscraper
ziff	business
zimbabwe	meltingpot
zola	olympia
