abc	picnicpark
acapulco	shangrila
adrenaline	
affection	
alexandra	meltingpot
angelic	roswell
apocalypse	cinerama
archerydrive	olympia
artists	
avenida	
babes	meltingpot
ball	stadium
bankrupt	campus
bear	business
ben	meltingpot
big	cinerama
bigband	madchester
blavatsky	roswell
blossom	picnicpark
blues	madchester
bob	boozers
bond	
bondi	shangrila
card	
castleton	picnicpark
centre	skyscraper
circus	southbank
classical	
cluster	jodrellbank
clyde	meltingpot
cocktavern	
comedy	cinerama
commercial	business
competing	olympia
computing	
craft	southbank
crossbar	stadium
crown	business
cuba	shangrila
cubist	
curiosity	
dance	madchester
decathlon	olympia
decimal	skyscraper
deer	
designers	campus
disco	madchester
doddington	picnicpark
doveside	meltingpot
dowsing	roswell
dragway	
dribble	
drink	amusement
economy	business
elephantandcastle	
enterprise	business
farley	meltingpot
fashion	campus
film	cinerama
financial	business
fish	safaripark
forbidden	jodrellbank
freelance	business
funk	madchester
garage	madchester
gates	business
glendower	boozers
global	
goodnight	business
graduation	picnicpark
grand	shangrila
greendale	picnicpark
gregory	
hastings	meltingpot
healing	
hibernium	picnicpark
hickory	meltingpot
hip	
hornton	southbank
howdy	southbank
howling	
hunt	business
hyperdrive	jodrellbank
ice	amusement
illinois	meltingpot
innovation	business
integer	skyscraper
international	
jazz	madchester
jinx	meltingpot
juke	
jupiter	jodrellbank
key	
kick	underworld
kings	meltingpot
kirkwall	picnicpark
las	shangrila
le	roswell
lights	cinerama
lkjlkj	southbank
lodge	meltingpot
lovecraft	
loverslane	
macro	skyscraper
manx	
mariachi	madchester
martial	olympia
meadow	
meadowbank	picnicpark
medal	olympia
media	southbank
medicine	
melbourne	meltingpot
memory	skyscraper
midfield	stadium
milky	
miller	
musical	southbank
new	southbank
oval	olympia
oxford	meltingpot
oxfordstreet	
parent	picnicpark
payoff	
penalty	stadium
philosophyway	
pinkplace	
pool	amusement
pop	madchester
pot	campus
priscilla	
prophecy	roswell
psychic	roswell
pub	
punk	madchester
puzzle	
python	cinerama
quarrybank	picnicpark
racing	underworld
radio	madchester
rainbow	picnicpark
rap	madchester
rave	madchester
relay	olympia
revenue	business
romance	
running	safaripark
sandringham	
sci	cinerama
shoot	underworld
silicon	skyscraper
simak	
sky	business
soccer	stadium
spells	
spiritual	southbank
sports	underworld
stadium	olympia
stock	business
strategy	underworld
striker	stadium
swamp	
takeover	
tennis	
theatre	
three	underworld
thriller	cinerama
thrillers	library
thunder	meltingpot
transfer	stadium
underworld	
universe	jodrellbank
vacation	picnicpark
venture	business
wasters	campus
western	cinerama
winner	pitstop
yellow	meltingpot
